1 -1
%%%%%%%%%
%      W%
%      L%
%       %
%%%%%%%%%